 ============
 ============
 ============
 ============
             
             
             
.====...====.
.............
.............
.............
############.
############.
############.
############.