#####============================#######
#####============================#######
#####============================#######
#####                    ........#######
##### ==#           #####........#######
=====   #           #===#........#######
=====   #...#...#...#===#........#######
=====   #...=...=...#===#........#######
=====   #...=...=   #   =........=======
=========...=...= . # . .........=======
=====    ... ...    #   #........=======
         ... ... ...#####........=======
#####    ... ... ...#####........       