#=============#
#=============#
#=============#
#             #
#.#####=#######
#.............#
#.............#
#.............#
#.............#