===========
===========
...........
#.=======.#
#.=======.#
#.###=#####
#    =    #
#         #
#         #
#         #