=============
=============
=============
=============
=============
             
========###  
===========  
===========  
......  ===  
....##  ===  
....##       
....##       
..===========
..===========
..===========
..===========
..===========
             
             
             
=== ===== ===
             
             
             
             
#########.###
#########.###
#########.###
#########.###
#########.###
#########.###
#########.###
#########.###
#########.###
#########.###
#########.###
#########.###