# =====#
# =====#
# =====#
#......#
#......#
#......#
#===== #
# MMMM #
# MMMM #
#      #
###### #