+++++++++++++++++++=
+++++++++++++++++++=
+++++++++++++++++++=
+++++++++++++++++++=
....................
#.###.##....##.###.#
=.=#=.=#....#=.=#=.=
=.++=.=#....#=.++=.=
   =   =....=   =   
       =....=       
   #    ....    #   