===+===+===+################====#===+===+===+===+===
===+===+===+################====#===+===+===+===+===
===+===+===+=+=+=+=+=+=+=+=+====#===+===+===+===+===
===+===+===+=+=+=+=+=+=+=+=+====#                   
===+===+===+=+=+=+=+=+=+=+=+====#       ############
            =+=+=+=+=+=+=+=+====#       ############
            =+=+=+=+=+=+=+=+====#       ############
########    =+=+=+=+=+=+=+=+====#       ############
########    =+=+=+=+=+=+=+==    #       ############
########                        ++++=  =############
########                                ############