####.#######################
####.#######################
====.#====#=====############
====.#====#=====############
====.#====#=====############
====.#====#=====############
=== .=====#=====############
    .=....=.    ############
    .=....=.    ############
    ......=.    ============
    .=......    ============
     =....#.    ============
    .=....=.    ============
    ......=.    ============
    .#....=.    ============
    .#......                