#===== #
#===== #
#      #
#      #
# ####=#
#MMMMM #
#M   M #
#MMMMM #
#      #
# ######