# #MMMMMMM# #
# #M     M# #
# #MMMMMMM# #
# ####@#### #
#           #
#           #
# @ @ @ @ @ #
#           #
#           #