# #MMMMMMM# #
# #M     M# #
# #MMMMMMM# #
# ####=#### #
#           #
#           #
# = = = = = #
#           #
#           #