============#=======##############
============#=======##############
============#=======##############
============#=======##############
============#=======##############
            =.......==############
#######     =.......==============
####### ... =.......==============
####### ... ........  ============
####### ... #.......# ============
#######     #.......# ============
#######     #.......#             