##### ##############
#     ########     #
#     .......#     #
#     #......#     #
#     #.......     #
#=====#......#     #
#     #......#     #
#     #......#     #
#     .......#     #
#     #      #     #
#########..#########
        #..#        
        #..#        
        #..#        
        #..#        
        #..#        
  #######..#######  
  #      ..      #  
  #      ..      #  
  #      ..      #  
  #      ..      #  
  #      ..      #  
  #      ..      #  
  #      ..      #  
  #              #  
  ############## #  