################################
################################
########================########
########================########
########                ########
========                ========
========                ========
========                ========
========                ========
========                ========
========                ========
                                