==+==+==+==+==+==+===
==+==+==+==+==+==+===
==+==+==+==+==+==+===
==+==+==+==+==+==+===
       @@@@@@@       
#####M#########M#####
#####M++++++++=M#####
#####M++++++++=M#####
#####M++++++++=M#####
#####M++++++++=M#####
#####...........#####
#####..!!!!!!!..#####
#####..!!!!!!!..#####
#####.+++=@++++=#####
#####           #####
##### MMMMMMMMM #####
#####           #####