=============
=============
=============
=============
=============
             
========###  
===========  
....    ===  
....##  ===  
....##       
....##       
.============
.============
.============
.============
.============
             
             
             
=== ===== ===
             
             
             
             
#########.###
#########.###
#########.###
#########.###
#########.###
#########.###
#########.###
#########.###
#########.###
#########.###
#########.###
#########.###