=====#####=====
===============
===============
   MM=====MM   
     =====     
##           ##
##           ##
##           ##
##           ##
##           ##
##           ##
##           ##