#########=========================
#########=========================
#########=========================
#########              .    ======
######===              .          
=========              .    ######
=========...#...## ###############
=========...#...#= =##############
=========...#...#= =##############
=========...=...== =##############
======   ...        ##############
         ...  .     ##############
######   ...        ##############