==+==+==+==+===
==+==+==+==+===
               
           #===
   ........#   
   ........#  #
   ........#  #
   ==+==+===  #
   ==+==+===  #
              #
###############