===========
===========
...........
#.===.===.#
#.===.===.#
#.###=#####
#    =    #
#         #
#         #
#         #