====+#####=====
====+====+=====
====+====+=====
     ====+     
     ====+     
##           ##
##           ##
##           ##
##           ##
##           ##
##           ##
##           ##