#=============#
#=============#
#=============#
#             #
#.#####.#######
#.............#
#.............#
#.............#
#.............#