=====#####=====
===============
===============
     =====     
     =====     
##           ##
##           ##
##           ##
##           ##
##           ##
##           ##
##           ##