#####.############
#####.############
#+++=.#+++=#++++=#
#+++=.#+++=#++++=#
#+++=.#+++=#++++=#
#     #....#     #
#     =....#     #
#     .....=     #
#     #.....     #
#@@@@@#....#++++=#
#     =....#     #
#     .....#     #
#     #....=     #
#     #          #
############.#####
############.+++=#
############.+++=#
############.+++=#
############.+++=#
############.+++=#
############     #