####.#######################
####.#######################
====.#====#=====############
====.#====#=====############
====.#====#=====############
====.#====#=====############
====.=====#=====############
    .=....=.    ############
    .=....=.    ############
    ......=.    ============
    .=......    ============
     =....#.    ============
    .=....=.    ============
    ......=.    ============
    .#....=.    ============
    .#......                