##################################
+==+===####################==+==+=
+==+======+===+===+===+======+==+=
       ===+===+===+===+====       
       ===+===+===+===+====       
#####  ===+===+===+===+====  #####
#####  ===+===+===+===+====  #####
#####  ===+===+===+===+====  #####
#####                        #####
#####                        #####