###############+++++++++++++++++++++++++++=#######
###############+++++++++++++++++++++++++++=#######
###############+++++++++++++++++++++++++++=#######
###############+++++++++++++++++++++++++++=#######
###############                      ...   #######
++++++++++++++=   =   =              ...   #######
++++++++++++++=   =   =   ###########...##########
++++++++++++++=           ########===...===#######
++++++++++++++=   =   =   ########   ...   +++++=#
                  =   =   ########   ......+++++=#
                          ########   ............#
##################################   ......#######
##################################         #######