###############===+===+===+===+===+===+====#######
###############===+===+===+===+===+===+====#######
###############===+===+===+===+===+===+====#######
###############===+===+===+===+===+===+====#######
###############                      ...   #######
==+==+==+==+===   =   =              ...   #######
==+==+==+==+===   =   =   ###########...##########
==+==+==+==+===           ########===...===#######
==+==+==+==+===   =   =   ########   ...   +++++=#
                  =   =   ########   ......+++++=#
                          ########   ............#
##################################   ......#######
##################################         #######