##################################
=======####################=======
==================================
       ====================       
       ====================       
#####  ====================  #####
#####  ====================  #####
#####  ====================  #####
#####                        #####
#####                        #####