===============
===============
               
           ####
   ........#   
   ........#  #
   ........#  #
   =========  #
   =========  #
              #
###############