+++++++++++++++++++=
+++++++++++++++++++=
+++++++++++++++++++=
+++++++++++++++++++=
........    ........
#.###.##    ##.###.#
=.=#=.+=    +=.=#=.=
   #            #   
   =   #    #   =   
       #    #       