============################====#===================
============################====#===================
================================#===================
================================#                   
================================#       ############
            ====================#       ############
            ====================#       ############
########    ====================#       ############
########    ================    #       ############
########                        ===== ==############
########                                ############