============################====#===================
============################====#===================
================================#===================
================================#                   
================================#       ############
      .     ====================#       ############
      .     ====================#       ############
########    ====================#       ############
########    ================    #       ############
########                        =====  =############
########                                ############