============#################=======================
============================#=======================
============================#=======================
============================#                       
============================#       ################
            ================#       ################
            ================#       ################
########    ================#       ################
########    ================#       ################
########                    ===== ========##########
########                                  ##########