==+==+==+==+==+==+===
==+==+==+==+==+==+===
==+==+==+==+==+==+===
==+==+==+==+==+==+===
       @@@@@@@       
#####.#########.#####
#####.++++++++=.#####
#####.++++++++=.#####
#####.++++++++=.#####
#####.++++++++=.#####
#####...........#####
#####..@@@@@@@..#####
#####..@@@@@@@..#####
#####.+++=@++++=#####
#####           #####
##### MMMMMMMMM #####
#####           #####