====================
====================
====================
====================
====================
                    
##### ######## #####
##### ======== #####
##### ======== #####
##### ======== #####
##### ======== #####
#####..........#####
#####..........#####
#####..........#####
#####.===..====#####
#####          #####
#####          #####
#####          #####
#####          #####