#####.############
#####.############
#+++=.#+++=#++++=#
#+++=.#+++=#++++=#
#+++=.#+++=#++++=#
#     #....#     #
#     =....#     #
#     .....=     #
#     #.....    @#
#@@@@@#....#++++=#
#     =....#    @#
#     .....#     #
#     #....=     #
#     #          #
############.#####
############.+++=#
############.+++=#
############.+++=#
############.+++=#
############.+++=#
############.+++=#
############.+++=#
############     #