# ++++=#
# ++++=#
# ++++=#
#......#
#......#
#......#
#@@@@@.#
# MMMM #
# MMMM #
#      #
# ######
# ######