#######....#####      
##    #....#   #      
###   #....#   #      
  #   ......   #      
  #   #....#   #######
  #   #....#          
  #####....###########