=============
=============
=============
=============
=============
             
=====   ###  
=====   ===  
....    ===  
....#   ===  
....=        
....         
.====   =====
.====   =====
.====   =====
.====   =====
.====   =====
             
             
             
=== =   = ===
             
             
             
             
#####   #.###
##### # #.###
##### # #.###
##### = #.###
##### = #.###
##### = #.###
##### = #.###
##### = #.###
#####   #.###
#########.###
#########.###
#########.###