#.#=+=+=+== #
#.#=+=+=+== #
#.#=+=+=+== #
#.#=+=+=+== #
#.#.....    #
#.#.@@@@@++=#
#.#.........#
#.#.........#
#.#.........#
#.#.........#
#.#.........#
#.#++=.++=#.#
#.#.......#.#
# #MMMMMMM# #
# #M     M# #
# #MMMMMMM# #
# #.......# #
# +++=@+++= #
#           #
#           #
#    @@@    #
#           #
#           #