##########.==========
==========.==========
==========           
========== ##########
========== ##########
           ##########
########## ##########
         # ##########