====== ======
====== ======
====== ======
====== ======
====== ======
             
====== =###  
====== ====  
....    ===  
....##  ===  
....##       
....##       
.===== ======
.===== ======
.===== ======
.===== ======
.====  ======
             
             
             
=== =  == ===
             
             
             
             
#########.###
#########.###
#########.###
#########.###
#########.###
#########.###
#########.###
#########.###
#########.###
#########.###
#########.###
#########.###