++++++++++=
++++++++++=
...........
#.@@@@@@@.#
#.@@@@@@@.#
#.++=@+++=#
#         #
#         #
#         #