=+======+==
=+======+==
...........
#.@@@@@@@.#
#.@@@@@@@.#
#.++=@+++=#
#         #
#         #
#         #