# =====#
# =====#
# =====#
#......#
#......#
#......#
#===== #
# MMMM #
# M  M #
# MMMM #
###### #