==+===######===####
==+===#....#===####
      #....#   ####
###   =....=   =+==
###   ......   =+==
###   #....#   =+==
###   #....#       
#######....########