###########==+==+==+==+==+==+===
###########==+==+==+==+==+==+===
###########                     
#########== =+==#=+==   ########
#########== =+==#=+==   ########
#########== =+==#=+==@##########
==+==+===MMMMM  =     ##########
==+==+===M   M  =     ##########
==+==+===MMMMM  =     ##########
                      ##########