+===+===+====
+===+===+====
+===+===+====
             
=+=+=+==###  
=+=+=+==++=  
......  ++=  
....##  ++=  
....##       
....##       
.############
.############
.==+==+==+===
.==+==+==+===
.==+==+==+===
      @      
@     @     @
 @    @    @ 
++= ++++= ++=
             
             
             
             
#########.###
#########.###
#########.###
#########.###
#########.###
#########.###
#########.###
#########.###
#########.###
#########.###
#########.###
#########.###