+===+===+====
+===+===+====
+===+===+====
             
##=+=+==###  
##=+=+==++=  
##...   ++=  
##...#  ++=  
##...#       
###.##       
###.#########
###.#########
#+=.+=#######
#     #######
# @@@ #######
#     #######
###.#########
++=.++++++++=
++=.++++++++=
++=.++++++++=
++=.++++++++=
@@           
  @@         
@@  @@       