===+===+===+################====#==+==+==+==+==+==+=
===+===+===+################====#==+==+==+==+==+==+=
===+===+===+=+=+=+=+=+=+=+=+====#==+==+==+==+==+==+=
===+===+===+=+=+=+=+=+=+=+=+====#                   
===+===+===+=+=+=+=+=+=+=+=+====#       ############
            =+=+=+=+=+=+=+=+====#       ############
            =+=+=+=+=+=+=+=+====#       ############
########    =+=+=+=+=+=+=+=+====#       ############
########    =+=+=+=+=+=+=+==    #       ############
########                        ++++=  =############
########                                ############