+===+===+====
+===+===+====
+===+===+====
+===+===+====
+===+===+====
             
=+=+=+==###  
=+=+=+==++=  
......  ++=  
....##  ++=  
....##       
....##       
.=+=+=+=+=+==
.=+=+=+=+=+==
.=+=+=+=+=+==
.=+=+=+=+=+==
.=+=+=+=+=+==
      @      
@@    @    @@
 @    @    @ 
++= ++++= ++=
@           @
             
             
@           @
#########.###
#########.###
#########.###
#########.###
#########.###
#########.###
#########.###
#########.###
#########.###
#########.###
#########.###
#########.###