=====###=====
=====###=====
=============
=============
=============
     ===     
  #  ===  #  
.............
             
.............
  #  ###  #  
     ###     