#             #
#MMMMMMMMMMMMM#
#MMMMMMMMMMMMM#
#             #
#.#####=#######
#.............#
#.............#
#.............#
#.............#